# Resources from graph.properties
alreadyConnected=Nodes already connected
cancel=Отмена
close=Закрыть
collapse-expand=Свернуть/Развернуть
containsValidationErrors=Присутствуют ошибки валидации
done=Готво
doubleClickOrientation=Двойной клик для смены ориентации
error=Ошибка
errorSavingFile=Ошибка при сохранении файла
ok=OK
updatingDocument=Обновление документа. Подождите...
updatingSelection=Обновление выделенной области. Подождите...
# Custom resources
about=Описание
actualSize=Актуальный размер
add=Добавить
addLayer=Добавить слой
addProperty=Добавить свойство
addToExistingDrawing=Добавить к текущему чертежу
addWaypoint=Add Waypoint
advanced=Расширенный
align=Выравнивание
alignment=Центровка
allChangesLost=Все изменения будут утеряны!
angle=Угол
apply=Применить
arc=Дуга
arrange=Расположение
arrow=Стрелка
arrows=Стрелки
automatic=Автоматическое
autosave=Автосохранение
autosize=Авто размер
back=Назад
background=Фон
backgroundColor=Цвет фона
backgroundImage=Фоновое изображение
basic=Базовый
block=Блок
blockquote=Blockquote
bold=Жирный
border=Рамка
borderWidth=Ширина рамки
borderColor=Цвет рамки
bottom=Снизу
bottomAlign=Выравниание по ниж. крайю
bottomLeft=Bottom Left
bottomRight=Bottom Right
bulletedList=Bulleted List
cannotOpenFile=Не получается открыть этот файл
center=Центр
change=Изменить
changeOrientation=Сменить ориентацию
circle=Окружность
classic=Классический
clearDefaultStyle=Очистить стили по умолчанию
clearWaypoints=Clear Waypoints
clipart=Клипарт
collapse=Свернуть
collapseExpand=Свернуть/Развернуть
collapsible=Сворачиваемый
comic=Забавный
connect=Связать
connection=Связь
connectionPoints=Связанные точки
connectionArrows=Стязывающие стрелки
constrainProportions=Связать пропорции
copy=Копировать
copyConnect=Копировать при подключении
copySize=Копировать размер
create=Создать
curved=Изогнутый
custom=Кастомный
cut=Вырезать
dashed=Штрихпунктирный
decreaseIndent=Уменьшить отступ
default=Дефолтный
delete=Удалить
deleteColumn=Удалить колонку
deleteRow=Удалить строку
diagram=Чертеж
diamond=Бриллиант
diamondThin=Бриллиант (тонкий)
direction=Направление
distribute=Распространять
divider=Разделитель
documentProperties=Свойства документа
dotted=Пунктирный
dpi=DPI
drawing=Drawing{1}
drawingEmpty=Drawing is empty
drawingTooLarge=Drawing is too large
duplicate=Дублировать
duplicateIt=Duplicate {1}
east=East
edit=Правка
editData=Изменить свойства
editDiagram=Изменить схему
editImage=Изменить изображение
editLink=Изменить ссылку
editStyle=Изменить стиль
editTooltip=Edit Tooltip
enterGroup=Включить в группу
enterValue=Введите значение
enterName=Ввудите название
enterPropertyName=Введите название свойства
entityRelation=Entity Relation
exitGroup=Исключить из группы
expand=Развернуть
export=Экспорт.
extras=Дополнения
file=Файл
fileNotFound=Файл не найден
filename=Имя файла
fill=Заливка
fillColor=Цвет заливки
fitPage=One Page
fitPageWidth=По ширине страницы
fitTwoPages=Two Pages
fitWindow=Вписать в окно
flip=Отразить
flipH=Отразить горизонт.
flipV=Отразить вертик.
font=Шрифт
fontFamily=Font Family
fontColor=Цвет текста
fontSize=Размер шрифта
format=Формат
formatPanel=Панель форматирования
general=Allgemein
formatPdf=PDF
formatPng=PNG
formatGif=GIF
formatJpg=JPEG
formatSvg=SVG
formatXml=XML
formatted=Форматированный
formattedText=Форматированный текст
gap=Gap
glass=Glass
general=Основные
global=Общий
gradient=Градиент
gradientColor=Цвет
grid=Сетка
gridSize=Размер сетки
group=Группа
guides=Направляющие
heading=Заголовок
height=Высота
help=Помощь
test=Test
1000=Render 1000 vertexes
2000=Render 2000 vertexes
hide=Скрыть
hideIt=Скрыть {1}
hidden=Скрытый
home=Home
horizontal=Горизонт.
horizontalFlow=Horizontal Flow
horizontalTree=Horizontal Tree
html=HTML
id=ID
image=Изобр.
images=Картинки
import=Импорт
increaseIndent=Увеличить отступ
insert=Вставить
insertColumnBefore=Insert Column Left
insertColumnAfter=Insert Column Right
insertHorizontalRule=Insert Horizontal Rule
insertImage=Вставить изображение
insertLink=Вставить ссылку
insertRowBefore=Insert Row Above
insertRowAfter=Insert Row Below
invalidInput=Invalid input
invalidName=Invalid name
invalidOrMissingFile=Invalid or missing file
isometric=Isometric
italic=Italic
layers=Слои
landscape=Альбомная
laneColor=Lanecolor
layout=Layout
left=Слева
leftAlign=Left Align
leftToRight=Слева направо
line=Линия
link=Ссылка
lineJumps=Line jumps
lineend=Line End
lineheight=Line Height
linestart=Line Start
linewidth=Linewidth
loading=Загрузка
lockUnlock=блок./разблок.
manual=Manual
middle=Middle
misc=Прочие
more=Еще
moreResults=More Results
move=Переместить
moveSelectionTo=Move Selection to {1}
navigation=Navigation
new=Новый
noColor=No Color
noFiles=No files
noMoreResults=No more results
none=None
noResultsFor=No results for '{1}'
normal=Normal
north=North
numberedList=Numbered List
opacity=Непрозрачность
open=Открыть
openArrow=Open Arrow
openFile=Открыть файл
openLink=Открыть ссылку
openSupported=Supported format is .XML files saved from this software
openInNewWindow=Открыть в новом окне
openInThisWindow=Открыть в текущем окне
options=Опции
organic=Organic
orthogonal=Orthogonal
outline=Контур
oval=Овал
pages=Страницы
pageView=Страничный режим
pageScale=Масштаб стр.
pageSetup=Настр. страницы
panTooltip=Пробел+Тянуть для прокрутки
paperSize=Размер холста
paste=Вставить
pasteHere=Вставить сюда
pasteSize=Размер вставки
pattern=Паттерн
perimeter=Периметр
placeholders=Плэйсхолдеры
plusTooltip=Click to connect and clone (ctrl+click to clone, shift+click to connect). Drag to connect (ctrl+drag to clone).
portrait=Портр.
position=Позиционир.
posterPrint=Poster Print
preview=Предпросмотр
print=Печать
radialTree=Radial Tree
redo=Повторить
removeFormat=Очистить форматирование
removeFromGroup=Удалить из группы
removeIt=Remove {1}
removeWaypoint=Remove Waypoint
rename=Переименовать
renameIt=Переименовать {1}
replace=Заменить
replaceIt={1} already exists. Do you want to replace it?
replaceExistingDrawing=Replace existing drawing
reset=Сбросить
resetView=Сброс представления
reverse=Обратно
right=Справа
rightAlign=По правому
rightToLeft=Справа налево
rotate=Повернуть
rotateTooltip=Click and drag to rotate, click to turn shape only by 90 degrees
rotation=Поворот
rounded=Закругленный
save=Сохранить
saveAs=Сохранить как
saved=Сохранено
scrollbars=Полосы прокрутки
search=Поиск
searchShapes=Поиск элементов
selectAll=Выбрать все
selectEdges=Выделение по краю
selectFont=Select a Font
selectNone=Снять выделение
selectVertices=Выделить вершины
setAsDefaultStyle=Сдеать стилем по умолчанию
shadow=Тень
shape=Форма
sharp=Sharp
sidebarTooltip=Click to expand. Drag and drop shapes into the diagram. Shift+click to change selection. Alt+click to insert and connect.
simple=Простой
simpleArrow=Простая стрелка
size=Размер
solid=Сплошной
sourceSpacing=Source Spacing
south=South
spacing=Отступы
straight=Прямой
strikethrough=Зачеркнутый
strokeColor=Цвет линии
style=Стиль
subscript=Subscript
superscript=Superscript
table=Таблица
targetSpacing=Target Spacing
text=Текст
textAlignment=Выравнивание текста
textOpacity=Непрозрачность текста
toBack=На слой ниже
toFront=На слой выше
tooltips=Всплывающие подсказки
top=Сверху
topAlign=Выравн. по верху
topLeft=Вверх влево
topRight=Вверх вправо
transparent=Прозрачный
turn=Поворот на 90°
uml=UML
underline=Подчеркнутый
undo=Отменить
ungroup=Разгруппировать
url=URL
untitledLayer=Безымянный слой
vertical=Вертикальный
verticalFlow=Vertical Flow
verticalTree=Vertical Tree
view=Вид
waypoints=Waypoints
west=West
width=Ширина
wordWrap=Перенос слов
writingDirection=Ориент. текста
zoom=Увеличение
zoomIn=Увеличить
zoomOut=Уменьшить
mm=мм
cm=см
m=м
unitsSelector=Единицы измерения
